{
  "query": "core_product_name: armoured communication cable | size: pairs: 2, diameter: 0.5 mm",
  "final_matches": [
    {
      "rank": 1,
      "fields_matched": [
        "core_product_name",
        "type_or_class"
      ],
      "match_details": {
        "text": "core_product_name: paired cable | type_or_class: Fire Alarm | type_or_class: Communication | type_or_class: Control",
        "raw_product_name": "CABLES-FIRE ALARM, COMMUNICATION AND CONTROL PAIRED",
        "list_of_product_ids": [
          "8998",
          "8993",
          "9371",
          "9194",
          "9200",
          "9204",
          "9207",
          "9238",
          "14647",
          "19040",
          "24042",
          "23893",
          "38754",
          "38620",
          "38839",
          "38594",
          "38703",
          "38780",
          "38648",
          "38728",
          "38871",
          "38913",
          "38939",
          "38675",
          "38976",
          "39003",
          "39031",
          "39099",
          "39067",
          "39129",
          "39177",
          "39216",
          "39258",
          "39300",
          "39336",
          "39372",
          "39401",
          "39431",
          "39482",
          "39537",
          "39564",
          "39602",
          "39626",
          "39654",
          "39688",
          "39728",
          "39798",
          "39826",
          "39897"
        ]
      }
    },
    {
      "rank": 2,
      "fields_matched": [
        "core_product_name",
        "type_or_class"
      ],
      "match_details": {
        "text": "core_product_name: communication cable | type_or_class: Communication",
        "raw_product_name": "COMMUNICATION CABLES",
        "list_of_product_ids": [
          "13928",
          "14726",
          "14769",
          "14836",
          "15182",
          "15180",
          "15332",
          "19318",
          "19184",
          "20041",
          "20093",
          "24068",
          "22823",
          "23920",
          "38661",
          "38857",
          "38580",
          "38606",
          "38766",
          "36639",
          "38634",
          "38825",
          "38899",
          "38925",
          "38689",
          "38714",
          "38740",
          "38962",
          "38989",
          "39017",
          "39046",
          "39085",
          "39115",
          "39160",
          "39205",
          "39244",
          "39279",
          "39325",
          "39361",
          "39390",
          "39420",
          "39471",
          "39526",
          "39553",
          "39591",
          "39615",
          "39643",
          "39677",
          "39717",
          "39787",
          "39815",
          "39886"
        ]
      }
    },
    {
      "rank": 3,
      "fields_matched": [
        "core_product_name",
        "construction_features"
      ],
      "match_details": {
        "text": "core_product_name: armoured cable | construction_features: Armour | special_attributes: Loop",
        "raw_product_name": "ARMOURED CABLE-(LOOP)",
        "list_of_product_ids": [
          "9936",
          "9937",
          "9938",
          "8890",
          "8911",
          "8937",
          "8941",
          "8949",
          "8945",
          "8953",
          "9082",
          "9086",
          "9090",
          "9094",
          "9098",
          "19456",
          "19459",
          "19521",
          "19532",
          "19549",
          "19556",
          "23874",
          "24037",
          "24686",
          "27123",
          "27118",
          "27127",
          "27131",
          "27135",
          "27162",
          "27167",
          "27172",
          "27181",
          "27283",
          "27337",
          "27358",
          "27398",
          "27433",
          "27520",
          "27526",
          "27539",
          "27544",
          "27553",
          "27580",
          "27638",
          "27646",
          "27682",
          "27673",
          "27771",
          "27789",
          "27810",
          "27900",
          "27917",
          "27962",
          "28028",
          "28080",
          "28067",
          "28145",
          "28115",
          "28111",
          "28107",
          "28271",
          "28283",
          "28295",
          "28291",
          "28347",
          "28385",
          "28381",
          "28413",
          "28419",
          "28458",
          "28455",
          "28466",
          "28498",
          "28514",
          "38762",
          "38596",
          "38683",
          "38622",
          "38711",
          "38650",
          "38736",
          "38847",
          "38879",
          "38921",
          "38947",
          "38984",
          "39011",
          "39039",
          "39064",
          "39107",
          "39137",
          "39185",
          "39213",
          "39266",
          "39287",
          "39333",
          "39369",
          "39398",
          "39428",
          "39479",
          "39534",
          "39561",
          "38788",
          "39599",
          "39623",
          "39651",
          "39685",
          "39725",
          "39795",
          "39823",
          "39894"
        ]
      }
    }
  ]
}