{
  "query": "core_product_name: fire bucket | size: quantity: 4 nos. | feature_or_specifications: included: sand, ms(mild steel) hooks, stand",
  "final_matches": [
    {
      "rank": 1,
      "fields_matched": [
        "core_product_name"
      ],
      "match_details": {
        "text": "core_product_name: fire bucket",
        "raw_product_name": "FIRE BUCKET",
        "list_of_product_ids": [
          "19466",
          "19467",
          "19465",
          "19463",
          "19523",
          "19530",
          "19551",
          "19558"
        ]
      }
    },
    {
      "rank": 2,
      "fields_matched": [
        "core_product_name"
      ],
      "match_details": {
        "text": "core_product_name: bucket",
        "raw_product_name": "ELEVATOR -BUCKET",
        "list_of_product_ids": [
          "6124",
          "5291",
          "9598",
          "9720",
          "9741",
          "9736"
        ]
      }
    },
    {
      "rank": 3,
      "fields_matched": [
        "core_product_name",
        "Material"
      ],
      "match_details": {
        "text": "core_product_name: round | material: MS (Mild Steel)",
        "raw_product_name": "MS ROUND",
        "list_of_product_ids": [
          "30196",
          "32891",
          "13504",
          "13511",
          "13489",
          "13518",
          "13524",
          "13530",
          "13537",
          "13544",
          "13558",
          "13551",
          "26246",
          "29406",
          "16067",
          "16106",
          "29429",
          "31907",
          "17722",
          "17738",
          "29467",
          "29481",
          "29534",
          "23326",
          "29888",
          "30348",
          "29540",
          "29570",
          "29855",
          "30356",
          "31544",
          "31688",
          "24732",
          "31134",
          "24751",
          "24759",
          "24870",
          "24858",
          "24847",
          "24894",
          "31379",
          "24916",
          "24925",
          "24903",
          "31573",
          "25001",
          "30790",
          "25020",
          "25005",
          "25049",
          "25038",
          "25031",
          "29605",
          "30910",
          "25083",
          "25074",
          "25065",
          "25060",
          "25108",
          "25117",
          "30379",
          "30538",
          "25129",
          "25138",
          "25156",
          "25168",
          "25195",
          "25184",
          "25177",
          "25206",
          "25218",
          "25236",
          "25257",
          "25246",
          "25271",
          "25287",
          "25297",
          "25301",
          "25314",
          "25339",
          "25323",
          "25351",
          "25367",
          "25390",
          "25379",
          "25410",
          "30948",
          "31144",
          "25495",
          "29629",
          "30031",
          "30399",
          "31166",
          "31386",
          "31832",
          "25862",
          "31862",
          "25934",
          "30547",
          "31337",
          "31842",
          "31406",
          "31597",
          "25976",
          "30061",
          "26121",
          "26155",
          "29682",
          "30572",
          "31090",
          "26180",
          "26274",
          "26306",
          "30964",
          "31446",
          "26332",
          "26357",
          "30088",
          "30594",
          "26378",
          "26443",
          "26492",
          "26466",
          "26534",
          "26540",
          "26572",
          "26598",
          "30434",
          "26621",
          "26644",
          "26702",
          "29697",
          "30105",
          "26725",
          "26821",
          "26830",
          "30619",
          "30985",
          "26913",
          "26949",
          "26976",
          "27007",
          "27157",
          "30457",
          "27186",
          "30128",
          "31198",
          "27233",
          "30168",
          "30149",
          "30657",
          "27261",
          "27290",
          "29722",
          "27313",
          "27393",
          "31454",
          "27419",
          "27445",
          "27557",
          "29742",
          "31223",
          "27585",
          "27614",
          "27668",
          "27686",
          "27846",
          "27893",
          "27853",
          "27936",
          "27966",
          "29771",
          "30671",
          "31052",
          "28000",
          "30487",
          "31737",
          "28036",
          "28102",
          "28152",
          "28138",
          "30216",
          "31644",
          "28324",
          "28301",
          "31261",
          "28358",
          "30243",
          "28389",
          "28445",
          "28470",
          "28520",
          "29799",
          "31265",
          "31477",
          "31619",
          "28552",
          "28647",
          "28685",
          "28700",
          "30700",
          "28726",
          "28863",
          "28857",
          "28887",
          "29828",
          "28939",
          "30265",
          "31291",
          "28944",
          "28976",
          "31683",
          "29016",
          "29023",
          "30721",
          "31514",
          "31010",
          "29068",
          "29072",
          "30305",
          "31315",
          "31522",
          "31070",
          "29160",
          "29136",
          "29163",
          "29192",
          "29229",
          "30313",
          "29348",
          "29325",
          "29351",
          "29375",
          "31943",
          "31951",
          "31974",
          "32024",
          "31996",
          "32052",
          "32090",
          "32114",
          "32145",
          "32173",
          "32207",
          "32257",
          "32373",
          "32309",
          "32335",
          "32411",
          "32433",
          "32455",
          "32538",
          "32588",
          "32617",
          "32637",
          "32665",
          "32735",
          "32781",
          "32824",
          "32855",
          "32916",
          "32966",
          "33052",
          "33072",
          "33104",
          "33156",
          "33131",
          "33221",
          "33288",
          "33316",
          "33358",
          "33399",
          "33468",
          "33519",
          "33580",
          "33654",
          "33693",
          "33722",
          "33741",
          "33765",
          "33793",
          "33827",
          "33877",
          "33853",
          "33924",
          "33963",
          "34046",
          "34067",
          "34096",
          "34123",
          "34148",
          "34179",
          "34201",
          "34223",
          "34261",
          "34290",
          "34356",
          "34385",
          "34424",
          "34446",
          "34468",
          "34503",
          "34525",
          "34548",
          "34605",
          "34654",
          "34707",
          "34737",
          "34758",
          "34805",
          "34784",
          "34860",
          "34831",
          "34884",
          "34935",
          "35024",
          "35059",
          "35081",
          "35103",
          "35125",
          "35168"
        ]
      }
    }
  ]
}