{
  "query": "core_product_name: copper armoured cable | size: cores: 2, cross section: 4 sq.mm | feature_or_specifications: material: copper, type: armoured",
  "final_matches": [
    {
      "rank": 1,
      "fields_matched": [
        "core_product_name",
        "Material"
      ],
      "match_details": {
        "text": "core_product_name: cable | material: Copper",
        "raw_product_name": "CABLE -COPPER",
        "list_of_product_ids": [
          "32910",
          "32911",
          "33009",
          "33041",
          "33195",
          "33260",
          "33562",
          "33633",
          "35922"
        ]
      }
    },
    {
      "rank": 2,
      "fields_matched": [
        "core_product_name",
        "construction_features"
      ],
      "match_details": {
        "text": "core_product_name: armoured cable | type_or_class: Power | construction_features: Armour",
        "raw_product_name": "ARMOURED CABLE-(POWER)",
        "list_of_product_ids": [
          "8891",
          "8910",
          "8938",
          "8942",
          "8950",
          "8946",
          "8954",
          "9083",
          "9087",
          "9091",
          "9095",
          "9099",
          "23875",
          "24038",
          "24687",
          "24728",
          "24957",
          "27122",
          "27117",
          "27126",
          "27130",
          "27134",
          "27161",
          "27166",
          "27171",
          "27180",
          "27284",
          "27336",
          "27357",
          "27397",
          "27432",
          "27519",
          "27525",
          "27538",
          "27543",
          "27552",
          "27579",
          "27637",
          "27645",
          "27681",
          "27672",
          "27770",
          "27788",
          "27809",
          "27899",
          "27916",
          "27961",
          "28027",
          "28079",
          "28068",
          "28144",
          "28114",
          "28110",
          "28106",
          "28270",
          "28282",
          "28294",
          "28290",
          "28349",
          "28384",
          "28380",
          "28412",
          "28420",
          "28457",
          "28454",
          "28465",
          "28497",
          "28513",
          "39980",
          "39981",
          "39982",
          "39983",
          "40102",
          "40105",
          "40106",
          "40103",
          "40104",
          "40107",
          "40108",
          "40109"
        ]
      }
    },
    {
      "rank": 3,
      "fields_matched": [
        "core_product_name",
        "construction_features"
      ],
      "match_details": {
        "text": "core_product_name: armoured cable | construction_features: Armour | special_attributes: Loop",
        "raw_product_name": "ARMOURED CABLE-(LOOP)",
        "list_of_product_ids": [
          "9936",
          "9937",
          "9938",
          "8890",
          "8911",
          "8937",
          "8941",
          "8949",
          "8945",
          "8953",
          "9082",
          "9086",
          "9090",
          "9094",
          "9098",
          "19456",
          "19459",
          "19521",
          "19532",
          "19549",
          "19556",
          "23874",
          "24037",
          "24686",
          "27123",
          "27118",
          "27127",
          "27131",
          "27135",
          "27162",
          "27167",
          "27172",
          "27181",
          "27283",
          "27337",
          "27358",
          "27398",
          "27433",
          "27520",
          "27526",
          "27539",
          "27544",
          "27553",
          "27580",
          "27638",
          "27646",
          "27682",
          "27673",
          "27771",
          "27789",
          "27810",
          "27900",
          "27917",
          "27962",
          "28028",
          "28080",
          "28067",
          "28145",
          "28115",
          "28111",
          "28107",
          "28271",
          "28283",
          "28295",
          "28291",
          "28347",
          "28385",
          "28381",
          "28413",
          "28419",
          "28458",
          "28455",
          "28466",
          "28498",
          "28514",
          "38762",
          "38596",
          "38683",
          "38622",
          "38711",
          "38650",
          "38736",
          "38847",
          "38879",
          "38921",
          "38947",
          "38984",
          "39011",
          "39039",
          "39064",
          "39107",
          "39137",
          "39185",
          "39213",
          "39266",
          "39287",
          "39333",
          "39369",
          "39398",
          "39428",
          "39479",
          "39534",
          "39561",
          "38788",
          "39599",
          "39623",
          "39651",
          "39685",
          "39725",
          "39795",
          "39823",
          "39894"
        ]
      }
    }
  ]
}