{
  "query": "core_product_name: chequered plate supply and fixing | size: thickness: 6 mm | feature_or_specifications: application: cable trench inside switch room, DG room, earthing pit, includes: cutting, painting, lifting hooks, standard: indian standard 3502",
  "final_matches": [
    {
      "rank": 1,
      "fields_matched": [
        "core_product_name"
      ],
      "match_details": {
        "text": "core_product_name: chequered plate",
        "raw_product_name": "CHEQUERED PLATE",
        "list_of_product_ids": [
          "29410",
          "29433",
          "29461",
          "29486",
          "31097",
          "29524",
          "29895",
          "29548",
          "29858",
          "31343",
          "29574",
          "31545",
          "31127",
          "30360",
          "31372",
          "30794",
          "31577",
          "31695",
          "29609",
          "30341",
          "30913",
          "31391",
          "30383",
          "31149",
          "25253",
          "25277",
          "25279",
          "25474",
          "25418",
          "30529",
          "30939",
          "25460",
          "25446",
          "25432",
          "29630",
          "30035",
          "25511",
          "25497",
          "25539",
          "25536",
          "31168",
          "25554",
          "25568",
          "25582",
          "25726",
          "25638",
          "25624",
          "25610",
          "25596",
          "25652",
          "25666",
          "25685",
          "25698",
          "25712",
          "25767",
          "25753",
          "25738",
          "25797",
          "25784",
          "25833",
          "25847",
          "25811",
          "25900",
          "25885",
          "25870",
          "31826",
          "25914",
          "25945",
          "30551",
          "30406",
          "31845",
          "31604",
          "25984",
          "26089",
          "26114",
          "29670",
          "26127",
          "30068",
          "30576",
          "31413",
          "26186",
          "26163",
          "26252",
          "26282",
          "26314",
          "30969",
          "26337",
          "26362",
          "30601",
          "26386",
          "26426",
          "26449",
          "26497",
          "26474",
          "26548",
          "26526",
          "26580",
          "26606",
          "30438",
          "30090",
          "31437",
          "26629",
          "26652",
          "26733",
          "26710",
          "26758",
          "26813",
          "29699",
          "30112",
          "26921",
          "26956",
          "30623",
          "30992",
          "31626",
          "26984",
          "26838",
          "27015",
          "27149",
          "30461",
          "30135",
          "27194",
          "27217",
          "27241",
          "30156",
          "30650",
          "31205",
          "27269",
          "27298",
          "29726",
          "30178",
          "27321",
          "27385",
          "31017",
          "31730",
          "27411",
          "27453",
          "27565",
          "31227",
          "27593",
          "29750",
          "30674",
          "31043",
          "27622",
          "27660",
          "27694",
          "27838",
          "27860",
          "27885",
          "27944",
          "27974",
          "30200",
          "31252",
          "28008",
          "29773",
          "31460",
          "28044",
          "28094",
          "28130",
          "28163",
          "30223",
          "31648",
          "28309",
          "28332",
          "31865",
          "28366",
          "30491",
          "31482",
          "28397",
          "28437",
          "28478",
          "28528",
          "30246",
          "31272",
          "28555",
          "28639",
          "28677",
          "28708",
          "30701",
          "28734",
          "28871",
          "28849",
          "28895",
          "29832",
          "30269",
          "28931",
          "28952",
          "31295",
          "31507",
          "28983",
          "29008",
          "29031",
          "30725",
          "29058",
          "29080",
          "30296",
          "31319",
          "31526",
          "29126",
          "31075",
          "31674",
          "29147",
          "29807",
          "29171",
          "29196",
          "29221",
          "30316",
          "29335",
          "29315",
          "29359",
          "29383",
          "31911",
          "31936",
          "31955",
          "31978",
          "32028",
          "32000",
          "32056",
          "32070",
          "32094",
          "32118",
          "32149",
          "32177",
          "32208",
          "32265",
          "32251",
          "32236",
          "32296",
          "32313",
          "32339",
          "32354",
          "32377",
          "32392",
          "32415",
          "32459",
          "32437",
          "32542",
          "32519",
          "32555",
          "32571",
          "32896",
          "32589",
          "32645",
          "32621",
          "32681",
          "32684",
          "32720",
          "32742",
          "32785",
          "32828",
          "32862",
          "32923",
          "32973",
          "33056",
          "33077",
          "33108",
          "33160",
          "33138",
          "33225",
          "33295",
          "33325",
          "33362",
          "33403",
          "33472",
          "33523",
          "33584",
          "33656",
          "33700",
          "33726",
          "33747",
          "33772",
          "33797",
          "33831",
          "33881",
          "33857",
          "33928",
          "33970",
          "34050",
          "34074",
          "34100",
          "34127",
          "34183",
          "34227",
          "34205",
          "34265",
          "34294",
          "34155",
          "34363",
          "34392",
          "34431",
          "34453",
          "34475",
          "34510",
          "34531",
          "34555",
          "34612",
          "34661",
          "34714",
          "34741",
          "34765",
          "34812",
          "34788",
          "34867",
          "34835",
          "34891",
          "34939",
          "35031",
          "35066",
          "35088",
          "35110",
          "35132",
          "35175"
        ]
      }
    },
    {
      "rank": 2,
      "fields_matched": [
        "core_product_name",
        "Material"
      ],
      "match_details": {
        "text": "core_product_name: plate | material: Steel",
        "raw_product_name": "STEEL PLATE",
        "list_of_product_ids": [
          "15457",
          "15466",
          "14057",
          "15473",
          "15475",
          "15478",
          "15836",
          "19346",
          "18374",
          "18349",
          "19348",
          "21285",
          "22300",
          "22845",
          "21288",
          "22303",
          "26241",
          "29274",
          "29273",
          "29270",
          "38270",
          "38278",
          "36661",
          "36651",
          "37396"
        ]
      }
    },
    {
      "rank": 3,
      "fields_matched": [
        "Material",
        "core_product_name"
      ],
      "match_details": {
        "text": "core_product_name: fabricated fitting | material: Plate | construction_features: Cladded",
        "raw_product_name": "FITTINGS FABRICATED FROM PLATE - CLADDED",
        "list_of_product_ids": [
          "6326",
          "5497",
          "11561",
          "24593",
          "34020",
          "34019",
          "36846"
        ]
      }
    }
  ]
}